@@@@@@@@@@@@@@@@@@@@@@@@@@@@@@@@
@  g                      m    @
@                              @
@........              ........@
@                              @
@           .......            @
@                              @
@   .#..                       @
@                              @
@                              @
@                              @
@..-......&            &...-...@
@                              @
@                              @
@                              @
@         ....-.......         @
@                              @
@                              @
@                              @
@.-....                  ....-.@
@                              @
@                              @
@            ...-..            @
@                              @
@ %                         *  @
@@@@@@@@@@@@@@@@@@@@@@@@@@@@@@@@

