@@@@@@@@@@@@@@@@@@@@@@@@@@@@@@@@            
@              @               @
@              @               @
@              @               @
@              @               @
@              @               @
@              @               @
@              @            *  @
@  %           @          .....@
@.....         @  .            @
@              @               @
@           ...@       .       @                                                           
@              @           ....@
@      .       @               @
@              @  .            @
@           ...@....           @
@ .            @               @
@.!...         @          ..#..@
@              @               @
@          ....@.....          @
@              @               @
@.!...         @         .!....@
@              @          g    @
@m       ......@......         @
@              @               @
@@@@@@@@@#@@@@@@@@@@@@@@!@@@@@@@