@@@@@@@@@@@@@@@@@@@@@@@@@@@@@@@@            
@                              @
@                              @
@                              @
@                     %     *  @
@               ...............@
@                              @
@     ....                     @
@                              @
@ .         .                  @
@......!......-........        @
@                      .       @                                                           
@                              @
@                              @
@                             .@
@          ........-...........@
@       ...                    @
@                              @
@                              @
@.                             @
@.............-........        @
@                      .       @
@                              @
@ g m                          @
@                            . @
@@@@@@@@@@@@@@!@@@@@#@@@@@@@@@@@