@@@@@@@@@@@@@@@@@@@@@@@@@@@@@@@@            
@                              @
@                              @
@                              @
@                              @
@                    %     *   @
@                ..............@
@     ....                     @
@                              @
@                              @
@..#..        .                @
@      .................       @                                                           
@                              @
@                              @
@                          ....@
@                              @
@          ........-...........@
@                              @
@                              @
@-............                 @
@               .........      @
@                           g  @
@...                           @
@ m                        ....@
@                              @
@@@@@@@@@@@@@@!@@@@@#@@@@@@@@@@@